++++++++++++++++++++++
    + +  ++ +  +  +++ 
+++   + + + +  + +  + 
+ + +  ++  +  ++++ ++ 
  +++ ++++++ +++  + + 
  +   + ++     + ++ + 
      + + +++ + +++++ 
 + +++ S +  + +++  ++ 
+     + +++ ++   + +  
 + +  + +++  ++ +++ + 
++++++++++++++++++++++
