++++++++++++++++++++++
   ++ +     ++  + ++ +
++    ++++     ++ S+++
  + +++++  + +  +  +++
+      + ++   ++++    
+ +  + +    +++       
  + + + +      +   ++ 
+ +  ++  ++ ++       +
+++ +     +   +  +++++
++ +++++ + + +  ++    
++++++++++++++++++++++
